XXXXXXXXXXXXXXXX
XS             X
XXXXXXXXXXXX   X
XXXXXXXXXXXX   X
XXXXXXXXXXXX   X
XXXXXXXXXXXX   X
XXXXXXXXXXXX   X
XXXXXXXXXXXX   X
XXXXXXXXXXXX   X
XXXXXXXXXXXX   X
XXXXXXXXXX     X
XXXXXXX        X
XXXX          BX
X           XB X
X           XBFX
XXXXXXXXXXXXXXXX
----------------
title: Level 2: The Journey Continues
nextMap: 1