WWWWWWWWWWWWWWWW
WS             W
WWWWWWWWWWWW   W
WWWWWWWWWWWW   W
WWWWWWWWWWWW   W
WWWWWWWWWWWW   W
WWWWWWWWWWWW   W
WWWWWWWWWWWW   W
WWWWWWWWWWWW   W
WWWWWWWWWWWW   W
WWWWWWWWWW     W
WWWWWWW        W
WWWW           W
W            BBW
W            BFW
WWWWWWWWWWWWWWWW
