XXXXXXXXXXXXXXXX
XS             X
XXXXXXXXXXXX   X
XXXXXXXXXXXX   X
XXXXXXXXXXXX   X
XXXXXXXXXXXX   X
XXXXXXXXXXXX   X
XXXXXXXXXXXX   X
XXXXXXXXXXXB   X
XXXXXXXXXXXX   X
XXXXXXXXXXXX   X
XXXXXXXXXXXX   X
XXXXXXXXXXXXXBXX
XXXXXXXXXXXXXBXX
XXXXXXXXXXXXXFXX
XXXXXXXXXXXXXXXX
----------------
title: Level 3: The Journey Ends
nextMap: 9001