WWWWWWWWWWWWWWWW
WS             W
WWWWWWWWWWWW   W
WWWWWWWWWWWW   W
WWWWWWWWWWWW   W
WWWWWWWWWWWW   W
WWWWWWWWWWWW   W
WWWWWWWWWWWW   W
WWWWWWWWWWWB   W
WWWWWWWWWWWW   W
WWWWWWWWWWWW   W
WWWWWWWWWWWW   W
WWWWWWWWWWWWWBWW
WWWWWWWWWWWWWBWW
WWWWWWWWWWWWWFWW
WWWWWWWWWWWWWWWW
