16,16
----------------
----------------
XXX-XXX-X---X-XX
X---X-X-XX-XX-X-
X-X-XXX-X-X-X-XX
X-X-X-X-X---X-X-
XXX-X-X-X---X-XX
----------------
----------------
XXX-X--X-XX-XXXX
X-X-X--X-X--X--X
X-X-X--X-XX-XXXX
X-X-X--X-X--X-X-
XXX--XX--XX-X--X
----------------
----------------
METADATA
title: You Win!
nextMap: 7
text: